NO ./drawable/ny.png
SO ./drawable/paris.png
WE ./drawable/paris.png
EA ./drawable/pari

C 0,0,255
F 255,0,0

   1111111111111111111
10000000000000000000001111
10000001110110000000000000011
101000000100000000100001
111110111011010000000000001000001
1000100000110010010001111111111111
111100111111110111100000000011
111100001111110000010101001
10000000100000001100000010001
10000N00000000001101010011111
1100000111010101111101111010111
11110111 1110101 10111101001
11111111 1111111 1111 1111111
