NO ./drawable/cherry.png 


EA ./drawable/wall.png  
SO ./drawable/flower.png  


F   51 ,151,    50
C   120,   11, 0

WE    ./drawable/lion.png  

a
        1111111111111111111111111
        1000000000000000000000001
        1011000000000000001000001
        1001000000100000000100001
111111111011010000000000001000001
100011000011001001000111111111111
11110111111111011110000000001
11110111111111011101010010001
11000000110101011100000010001
100W000100000001100000010001
10000000000000011100110010001
1100000111010101111101111010111
11110111 1110101 101111010001
11111111 1111111 111111111111







